"filename", "language", "Vue", "JavaScript", "CSS", "JSON", "HTML", "comment", "blank", "total"
"d:\Graduation Thesis\dark\policy-llm\src\App.vue", "Vue", 27, 0, 0, 0, 0, 0, 3, 30
"d:\Graduation Thesis\dark\policy-llm\src\api\getData.js", "JavaScript", 0, 17, 0, 0, 0, 2, 3, 22
"d:\Graduation Thesis\dark\policy-llm\src\api\index.js", "JavaScript", 0, 69, 0, 0, 0, 15, 13, 97
"d:\Graduation Thesis\dark\policy-llm\src\api\path.js", "JavaScript", 0, 23, 0, 0, 0, 0, 5, 28
"d:\Graduation Thesis\dark\policy-llm\src\assets\font\demo.css", "CSS", 0, 0, 435, 0, 0, 19, 86, 540
"d:\Graduation Thesis\dark\policy-llm\src\assets\font\demo_index.html", "HTML", 0, 0, 0, 0, 231, 2, 25, 258
"d:\Graduation Thesis\dark\policy-llm\src\assets\font\iconfont.css", "CSS", 0, 0, 22, 0, 0, 0, 6, 28
"d:\Graduation Thesis\dark\policy-llm\src\assets\font\iconfont.js", "JavaScript", 0, 1, 0, 0, 0, 0, 0, 1
"d:\Graduation Thesis\dark\policy-llm\src\assets\font\iconfont.json", "JSON", 0, 0, 0, 30, 0, 0, 1, 31
"d:\Graduation Thesis\dark\policy-llm\src\components\ChangPassword.vue", "Vue", 226, 0, 0, 0, 0, 0, 7, 233
"d:\Graduation Thesis\dark\policy-llm\src\components\Emoji.vue", "Vue", 151, 0, 0, 0, 0, 3, 4, 158
"d:\Graduation Thesis\dark\policy-llm\src\components\FileCard.vue", "Vue", 84, 0, 0, 0, 0, 1, 3, 88
"d:\Graduation Thesis\dark\policy-llm\src\components\HeadPortrait.vue", "Vue", 32, 0, 0, 0, 0, 1, 3, 36
"d:\Graduation Thesis\dark\policy-llm\src\components\HelloWorld.vue", "Vue", 127, 0, 0, 0, 0, 0, 3, 130
"d:\Graduation Thesis\dark\policy-llm\src\components\Nav.vue", "Vue", 297, 0, 0, 0, 0, 5, 22, 324
"d:\Graduation Thesis\dark\policy-llm\src\components\PersonCard.vue", "Vue", 241, 0, 0, 0, 0, 3, 3, 247
"d:\Graduation Thesis\dark\policy-llm\src\components\login\LoginForm.vue", "Vue", 183, 0, 0, 0, 0, 2, 7, 192
"d:\Graduation Thesis\dark\policy-llm\src\components\login\RegisterForm.vue", "Vue", 220, 0, 0, 0, 0, 2, 7, 229
"d:\Graduation Thesis\dark\policy-llm\src\main.js", "JavaScript", 0, 39, 0, 0, 0, 1, 8, 48
"d:\Graduation Thesis\dark\policy-llm\src\mock\index.js", "JavaScript", 0, 0, 0, 0, 0, 275, 13, 288
"d:\Graduation Thesis\dark\policy-llm\src\registerServiceWorker.js", "JavaScript", 0, 31, 0, 0, 0, 1, 3, 35
"d:\Graduation Thesis\dark\policy-llm\src\router\index.js", "JavaScript", 0, 55, 0, 0, 0, 14, 7, 76
"d:\Graduation Thesis\dark\policy-llm\src\store\index.js", "JavaScript", 0, 33, 0, 0, 0, 0, 1, 34
"d:\Graduation Thesis\dark\policy-llm\src\util\requests.js", "JavaScript", 0, 31, 0, 0, 0, 2, 5, 38
"d:\Graduation Thesis\dark\policy-llm\src\util\util.js", "JavaScript", 0, 160, 0, 0, 0, 32, 16, 208
"d:\Graduation Thesis\dark\policy-llm\src\utils\gogocodeTransfer.js", "JavaScript", 0, 56, 0, 0, 0, 3, 1, 60
"d:\Graduation Thesis\dark\policy-llm\src\views\AboutView.vue", "Vue", 5, 0, 0, 0, 0, 0, 1, 6
"d:\Graduation Thesis\dark\policy-llm\src\views\HomeView.vue", "Vue", 15, 0, 0, 0, 0, 1, 3, 19
"d:\Graduation Thesis\dark\policy-llm\src\views\chat\ChatView.vue", "Vue", 8, 0, 0, 0, 0, 0, 2, 10
"d:\Graduation Thesis\dark\policy-llm\src\views\home.vue", "Vue", 46, 0, 0, 0, 0, 0, 3, 49
"d:\Graduation Thesis\dark\policy-llm\src\views\login\LoginView.vue", "Vue", 90, 0, 0, 0, 0, 0, 6, 96
"d:\Graduation Thesis\dark\policy-llm\src\views\pages\chatHome\chatwindow.vue", "Vue", 610, 0, 0, 0, 0, 49, 23, 682
"d:\Graduation Thesis\dark\policy-llm\src\views\pages\chatHome\index.vue", "Vue", 288, 0, 0, 0, 0, 5, 21, 314
"d:\Graduation Thesis\dark\policy-llm\src\views\pages\lingting.vue", "Vue", 4, 0, 0, 0, 0, 0, 2, 6
"d:\Graduation Thesis\dark\policy-llm\src\views\pages\setting.vue", "Vue", 6, 0, 0, 0, 0, 0, 2, 8
"d:\Graduation Thesis\dark\policy-llm\src\views\pages\video.vue", "Vue", 6, 0, 0, 0, 0, 0, 2, 8
"Total", "-", 2666, 515, 457, 30, 231, 438, 320, 4657